Size 11
XXXXXXXXXXX
X1 OOOOO  X
X XOXOXOX X
XOOOOOOOOOX
XOXOXOXOXOX
XOOOOOOOOOX
XOXOXOXOXOX
XOOOOOOOOOX
X XOXOXOX X
X3 OOOOO 4X
XXXXXXXXXXX