Size 11
XXXXXXXXXXX
X1 OOOOO 3X
X XOXOXOX X
XOOOOOOOOOX
XOXOXOXOXOX
XOOOOOOOOOX
XOXOXOXOXOX
XOOOOOOOOOX
X XOXOXOX X
X2 OOOOO 4X
XXXXXXXXXXX